*MAP
16 11
#=====#.........
#     #.........
===== =        .
..... . ...... .
.....   ...... .
.   ......     .
. .      . .....
. ......   .   .
. ..   ..... . .
.    .       . .
................
*ITEM
0 1 1 0 0	| player
2 14 9 29 2	| place
-1
*SCRIPT
Move the bot to the mark, 
without falling!

