*MAP
16 12
#========...===#
#        ..    #
#        .     #
#              #
#              #
#              #
#              #
#              #
#   .......    #
#   .......    #
#              #
================
*ITEM
0 4 5 0 0	| player
2 11 5 29 2	| place
1 8 5 22 0	| box
1 3 7 22 0	| box
*SCRIPT

