*MAP
16 16
#==============#
#              #
#              #
#              #
#              #
#              #
#              #
#              #
#              #
#              #
#              #
#              #
#              #
#              #
#              #
================
*ITEM
0 4 8 0 0	| player
1 12 8 22 0	| box
2 10 2 30 8	| coin
2 8 2 38 2 
-1
2 4 2 30 8	| coin
2 6 2 30 8	| coin
2 8 2 30 8	| coin
